11111111
1P0001E1
10000111
10100101
1010C001
10111101
100000C1
11111111