1111111
101C101
101E101
101C101
1000001
1000001
100P001
1111111