1111111
10PEC01
1000001
100001
1111111