11111111111
1PCCCCCCCC1
1CCCCCCCCC1
1CCCCCCCME1
11111111111