111111
100001
100001
10PC01
1010E1
111111