111111111111111
10P0000000C0001
11111C111111101
111111111111101
1000000000000C1
10111111C111111
101111111111111
1000C0000000001
111111111C11101
111111111111101
1000000C0000001
10E000000000001
111111111111111