111111111
100010001
10C000C01
1000P0001
100000001
1E0000001
111111111