1111111
1000001
100C001
1EP0101
100C001
10000C1
1111111