111111111
1001P10C1
1001C10C1
1000CCCC1
100010001
100000E01
111111111