11111111
1P000CE1
101111C1
10100101
1010C101
10111101
10000001
11111111