111111
1P1C11
101E11
100C01
100001
111111