111111111111111
10P000000000001
111111111111101
100000000000101
11110101100C101
1000C1011111101
10111100000M001
100000000E00001
111111111111111