1111111111
1PCCM0CC01
1C00C000E1
1111111111