111111111111
1P0000000011
111111111011
1000000C1001
101111111C11
100000C00011
101111111011
100000M00011
11111E111111
111111111111