111111111
1P00000C1
111111101
1C00000C1
101111111
1C00000E1
111111111