11111111
10P00001
10000001
1000C0E1
11111111