1111111111
1P01000001
1000100001
1010010001
1001001001
1000100101
100001C011
1000001001
100000C1E1
1111111111